R 800 500

NO ./textures/WALL38.xpm

SO ./textures/WALL66.xpm

WE ./textures/WALL68.xpm

EA ./textures/WALL74.xpm

S ./textures/barrel.xpm

F 255,200,160

C 255,200,150

 1111111111111111
10000000000000001
10200000200000201
10000000000000001
10002000200020001
10000000000000001
10202020N02020201
10000000000000001
10002000200200001
10000000000000001
10200000200002001
1000000T000000001
1111111111111111